1111111111111
1B010000000C1
1000011111B01
1P0011E000001
1111111111111