1111111111111111111111111111111111
1E0000B00000000C00000C000000000001
1010010100100011101001000000010101
10100100101010100010010000B0010101
1P0000000C00C000000B000000000000C1
1111111111111111111111111111111111