11111111111111111111
1C0000B00000000C0B01
101001011010B0111011
1010C100C01C10100011
1P000111B0111000C001
100B0C01000010B00111
1B01010101101C110111
100C0E000C10001C0B01
11111111111111111111